Desert Treasure
An Interactive Fiction by Austin Ishii
Release 1 / Serial number 131001 / Inform 7 build 6G60 (I6/v6.32 lib 6/12N) SD

Entrance
The dark hallway is covered in dozens of various depictions of Ancient Egyptian art depicing the life of the Pharoah and his Queen. It is slightly stuffy here, no doubt due the amount of time that this tomb has been sealed away.

>south
Desert
The sands of the desert irritates your eyes as you look around. The entire desert is silent, and the only thing you can hear are your own heat-beat and the sound of your own breathing. It's freezing cold right now since blazing desert sun has set beyond the horizon. The Pyramid that holds the legendary Eye of Horus is stands before you, glowing with an eerie light.

>north
Entrance
The dark hallway is covered in dozens of various depictions of Ancient Egyptian art depicing the life of the Pharoah and his Queen. It is slightly stuffy here, no doubt due the amount of time that this tomb has been sealed away.

>nw
You can't go that way.

>north
main hall
The main hall is a wonderous location, the walls rich with dozens of hieroglyphs as well as various pictures of the King and Queen as they adorn the walls. It shows their triumphs as they ruled their kingdom with a strange artifact in hand. It is a large jewel with gold decorations. There's not doubt about it, this is the Eye of Horus.

>nw
You can't go that way.

>northwest
You can't go that way.

>north
Treasury

I beg your pardon?

>southwest
You can't go that way.

>norht
That's not a verb I recognise.

>north
You can't go that way.

>south
main hall
The main hall is a wonderous location, the walls rich with dozens of hieroglyphs as well as various pictures of the King and Queen as they adorn the walls. It shows their triumphs as they ruled their kingdom with a strange artifact in hand. It is a large jewel with gold decorations. There's not doubt about it, this is the Eye of Horus.

>west
Hall of the Pharoah

>north
King's chamber

>south east
I only understood you as far as wanting to south.

>south
Hall of the Pharoah

>north
King's chamber