After hours of wandering through the desert, you find shelter from a sandstorm in a mysterious building. You have no idea where you are, but you are about to find out…

Desert Treasure
An Interactive Fiction by Austin Ishii
Release 1 / Serial number 131017 / Inform 7 build 6G60 (I6/v6.32 lib 6/12N) SD

Darkness
It is pitch dark, and you can't see a thing.

>switch flashlight on
You turn the flashlight on, providing a small source of light for now. You better be careful, it doesn't look like you have much battery left.

Entrance
The hallway is covered in dozens of various depictions of Ancient Egyptian art depicing the life of the Pharoah and his Queen. It is slightly stuffy here, no doubt due the amount of time that this tomb has been sealed away.

You can see a Torch here.

>take torch
Taken.

>north
Main hall
The main hall is a wonderous location, the walls rich with dozens of hieroglyphs as well as various pictures of the King and Queen as they adorn the walls. It shows their triumphs as they ruled their kingdom with a strange artifact in hand. It is a large jewel with gold decorations. It looks very important.

You can see a Queen's Door and a King's Door here.

Your flashlight sputters and dies. You shake it before you realize that it is really dead before throwing it away in disgust.  
It is now pitch dark in here!

>x door
You can't see any such thing.

>king's door
That's not a verb I recognise.

>king's door
That's not a verb I recognise.

>x king's door
You can't see any such thing.

>x door
You can't see any such thing.

>light torch with matches
You manage to light the torches with the match. It burns brightly in your grip, illuminating everything around you.

Main hall
The main hall is a wonderous location, the walls rich with dozens of hieroglyphs as well as various pictures of the King and Queen as they adorn the walls. It shows their triumphs as they ruled their kingdom with a strange artifact in hand. It is a large jewel with gold decorations. It looks very important.

You can see a Queen's Door and a King's Door here.

>x king's door
A large stone door with two oil lanterns.

>x queen's door
You touch the beautiful pictures that adorn the door before you hear a voice. 

 "You are not welcome here. Leave this place now!" 

You are startled by the sudden noise as you look around for where the voice came from. When you turn back to the door, you realize that there is something inside.

>west
(first opening the King's Door)
It seems to be locked.

>east
(first opening the Queen's Door)

Hall of the moon
The Hall is filled with adornments, praising the Queen entombed here. There is a ornate door to the north and the Main hall is to the west.
 "I warned you to leave." the voice growls again. It is then that you realize that the voice is coming from the Jackal! 
 "Why are you still here?" he asks menacingly, slowly getting closer to you. Maybe you should try talk to him…湩栠污⁬獩琠⁯桴瑡⁥潤牯琠⁯桴⁥潮瑲⁨湡⁤桴⁥慍湩栠污⁬獩琠⁯桴⁥敷瑳ਮ∠⁉慷湲摥礠畯琠⁯敬癡⹥" the Main hall is to the west.

You can see a Silver Door, a Queen's Door, and a Large Black Jackal here.

>talk to jackal
You explain to the jackal why you're here. You're stuck here because of a sandstorm and you can't get out. The jackal narrows his eyes and tilts his head. 
 "It seems you aren't lying." he says. "This tomb is protected by that sandstorm, if you want to leave you will need to open the Treasury and claim the Eye of Horus. I will be watching you…" The jackal turns and leaves the room and goes into the main hall.

>take mirror
The mirror pops off of the door easily, as if it was meant to come off. You hear the sound of stones grinding as the door to the Queen's chamber slowly opens.

>north
(first opening the Silver Door)

Queen's Chamber
The Queen's resting place is covered in hundreds of various pictures, depicting the Queen in all of her splendor. Her sarcophagus lies in the center of the tomb, undisturbed. However, there is a shining amulet on the wall in the back.

You can see a Silver Door and Queen's Amulet here.

>take amulet
"It seems you were trustworthy after all." the jackal states as he walks into the chamber. "If you weren't the amulet would have burned you to ash. But you still are alive and well. You will need to claim the Pharoah's crown to open the Treasury." The Jackal moves back out the door where he came in

>drop mirror
Dropped.

>undo
Queen's Chamber
[Previous turn undone.]

>south
Hall of the moon
The Hall is filled with adornments, praising the Queen entombed here. There is a ornate door to the north and the Main hall is to the west.

You can see a Silver Door and a Queen's Door here.

>east
You can't go that way.

>west
Main hall
The main hall is a wonderous location, the walls rich with dozens of hieroglyphs as well as various pictures of the King and Queen as they adorn the walls. It shows their triumphs as they ruled their kingdom with a strange artifact in hand. It is a large jewel with gold decorations. It looks very important.

You can see a Queen's Door, a King's Door, and a Large Black Jackal here.

>light lanterns with torch
You light the lanterns with your torch. The moment the second one is lit, the door slowly creaks open.

>x king's door
A large stone door with two lit lanterns that are burning brightly.

>east
Hall of the moon
The Hall is filled with adornments, praising the Queen entombed here. There is a ornate door to the north and the Main hall is to the west.

You can see a Queen's Door and a Silver Door here.

>west
Main hall
The main hall is a wonderous location, the walls rich with dozens of hieroglyphs as well as various pictures of the King and Queen as they adorn the walls. It shows their triumphs as they ruled their kingdom with a strange artifact in hand. It is a large jewel with gold decorations. It looks very important.

You can see a Queen's Door, a King's Door, and a Large Black Jackal here.

>west
(first opening the King's Door)

Hall of the Sun
This chamber is dedicated to the triumphs that the Pharoah went through in life. Sunlight shines from a opening in the ceiling onto a pedestal in the center of the room.

You can see a Golden Door, a King's Door, and Pedestal (empty) here.

>x pedestal
A large pedestal with a circular frame. It looks like the mirror could fit here…

>put mirror in pedestal
You put the mirror into the pedestal and you are nearly blinded as the shining mirror is redirected into your eyes! Blinking away the bright spots in your visions as you step back an admire you handywork.

>rotate pedestal
Nothing obvious happens.

>x pedestal
A large pedestal with a circular frame.The mirror that you found is fixed in place.

>take
What do you want to take?

>pedestal
You shake your head. There's no way you could lift that!

>rotate pedestal
Nothing obvious happens.

>turn pedestal
Nothing obvious happens.

>move pedestal
Nothing obvious happens.

>rotate pedesta;
You can't see any such thing.

>rotate pedestal
Nothing obvious happens.

* * *

>take torch
Taken.

>light torch with matches
You manage to light the torches with the match. It burns brightly in your grip, illuminating everything around you.

>north
Main hall
The main hall is a wonderous location, the walls rich with dozens of hieroglyphs as well as various pictures of the King and Queen as they adorn the walls. It shows their triumphs as they ruled their kingdom with a strange artifact in hand. It is a large jewel with gold decorations. It looks very important. A foutain of glittering water lies in the center of the room.

You can see a Queen's Door, a King's Door, and an Ornate Door here.

Your flashlight sputters and dies. You shake it before you realize that it is really dead before throwing it away in disgust. Thankfully you lit the torch before you came in so you have some lighting.

>west
(first opening the King's Door)
It seems to be locked.

>light lanterns with torch
You light the lanterns with your torch. The moment the second one is lit, the door slowly creaks open.

>east
(first opening the Queen's Door)
You touch the beautiful pictures that adorn the door before you hear a voice. 

 "You are not welcome here. Leave this place now!" 

You are startled by the sudden noise as you look around for where the voice came from. When you turn back to the door, you realize that there is something inside.

>east
(first opening the Queen's Door)

Hall of the moon
The Hall is filled with adornments, praising the Queen entombed here. There is a ornate door to the north and the Main hall is to the west.
 "I warned you to leave." the voice growls again. It is then that you realize that the voice is coming from the Jackal! 
 "Why are you still here?" he asks menacingly, slowly getting closer to you. Maybe you should try talk to him…‮桔牥⁥獩愠漠湲

You can see a Silver Door, a Queen's Door, and a Large Black Jackal here.

>talk to jackal
You explain to the jackal why you're here, that you're stuck here because of a sandstorm and you can't get out. The jackal narrows his eyes and tilts his head. 

"It seems you aren't lying." he says. "This tomb is protected by that sandstorm, if you want to leave you will need to open the Treasury and claim the Eye of Horus. I will be watching you…" 

The jackal turns and leaves the room and goes into the main hall.

>north
(first opening the Silver Door)
It seems to be locked.

>take mirror
The mirror pops off of the door easily, as if it was meant to come off. You hear the sound of stones grinding as the door to the Queen's chamber slowly opens.

>take
What do you want to take?

>north
You must name something more substantial.

>north
(first opening the Silver Door)

Queen's Chamber
The Queen's resting place is covered in hundreds of various pictures, depicting the Queen in all of her splendor. Her sarcophagus lies in the center of the tomb, undisturbed. However, there is a shining amulet on the wall in the back.

You can see a Silver Door and Queen's Amulet here.

>take amulet
"It seems you were trustworthy after all." the jackal states as he walks into the chamber. 

"If you weren't the amulet would have burned you to ash. But you still are alive and well. You will need to claim the Pharoah's crown to open the Treasury." The Jackal moves back out the door where he came in

>south
Hall of the moon
The Hall is filled with adornments, praising the Queen entombed here. There is a ornate door to the north and the Main hall is to the west.

You can see a Silver Door and a Queen's Door here.

>south
You can't go that way.

>west
Main hall
The main hall is a wonderous location, the walls rich with dozens of hieroglyphs as well as various pictures of the King and Queen as they adorn the walls. It shows their triumphs as they ruled their kingdom with a strange artifact in hand. It is a large jewel with gold decorations. It looks very important. A foutain of glittering water lies in the center of the room.

You can see a Queen's Door, a King's Door, an Ornate Door, and a Large Black Jackal here.

>west
(first opening the King's Door)

Hall of the Sun
This chamber is dedicated to the triumphs that the Pharoah went through in life. Sunlight shines from a opening in the ceiling onto a pedestal in the center of the room.

You can see a Golden Door and a King's Door here.

>put mirror in pedestal
You put the mirror into the pedestal and you are nearly blinded as the shining mirror redirects the sunlight into you eyes. The moment you move out of the way, the beam of sunlight shines upon the jewel in the door's center. It shines red as the door slowly rumbles open.

>north
King's chamber
The King's chamber displays his grandeur and wealth, as well as his glory as the ruler of Egypt. The King's sarcophagus lies in the enter of the room, glittering in the light. The crown rests on a pedestal before you, shining like a glowing star.

You can see a Golden Door and King's Crown here.

>take crown
You take the crown from the pedestal and you feel its weight in your hands. It feels strange to hold such a precious treasure. But it looks like you have all the things you need to open the treasury.

But the quickly jackal rushes into the room as it slams shute behind him, "There are intruders in the tomb! Seal the King's chamber or else they will defile it!" he shouts, he's clearly panicked. He tosses you a golden key. 

 "I have already locked the Queen's chamber. Hurry!"

>take key
Taken.

>lock door with key
You quickly lock the door with the key that was given to you. The jackal quickly nods and takes the key back from you, moving off to the side of the room. 

 "Pull this," he says as he indicates to hidden protrusion on the wall. It looks like an ancient lever. "It will take you back to the Main Hall. Then we can deal with the intruders permanently."

>unlock door
What do you want to unlock the Golden Door with?

>key
You can't see any such thing.

>pull lever
The wall slides open, revealing a hidden passageway. The Jackal quickly descends into the dark tunnel as you follow after him. When you finally reach the end, you find yourself back into the Main Hall as the passageway closes behind you. 

 The Jackal nods towards the entrance to the King's door. "All that is left is to lock them in the room. There is not that many things of value in there, thankfully. I managed to take the mirror with me before I left."

Main hall
The main hall is a wonderous location, the walls rich with dozens of hieroglyphs as well as various pictures of the King and Queen as they adorn the walls. It shows their triumphs as they ruled their kingdom with a strange artifact in hand. It is a large jewel with gold decorations. It looks very important. A foutain of glittering water lies in the center of the room.

You can see a Queen's Door, a King's Door, and an Ornate Door here.

>north
(first opening the Ornate Door)
The Jackal shakes his head, "You should probably get rid of the intruders first."

>put crown in slots
The Crown slides in with a gentle click as it glows with power.

>put amulet in slot
The Amulet slides in with a gentle click as it glows.

The ornate door clicks as it glows with power before the locks fall away. 

"Good" the Jackal says he he takes both artifacts. "Now the treasury is open."

>x door
Which do you mean, the Queen's Door, the King's Door, or the Ornate Door?

>ornate door
A very ornate door decorated with gold and silver hieroglyphs. The Queen and the King are on opposite sides of the door. There's a feather-shaped slot and a crown shaped slot in the center of the door.

>x slots
A pair of slots in the door. You probably need to fill both of them to open the door.

>north
(first opening the Ornate Door)
The Jackal shakes his head, "You should probably get rid of the intruders first."

I beg your pardon?

>north
(first opening the Ornate Door)
The Jackal shakes his head, "You should probably get rid of the intruders first."

>exitinguish lanterns
That's not a verb I recognise.

>extinguish lanters
You can't see any such thing.

>extinguish lanterns
You blow out both lanterns quickly. The moment the second one goes out the door slams shut.
 You hear a cry of alarm as the thieves realize that they're trapped in the room!

The Jackal nods, "Good." he says "Stand back from the door," he instructs. 

After you do so, his eyes glows red. There's a bright flash of light that forces you to close your eyes. You hear the screams of the thieves before the voices are cut off. When you open your eyes nothing seems to have been changed. 

 "The thives are gone now." the Jackal smirked, "Thank you for your assistance." he says, smiling.

>north
(first opening the Ornate Door)
You slowly open the door with apprehension on your face.

Treasury
A room filled with various treasures. All of Egypt's wealth is here. In the center of the room is a bejeweled pedestal with a diamond set in gold, silver, and lapis-lazuli. It glows with a mysterious power.

 "Behold." the Jackal states, "The Eye of Horus, the greatest treasure in all of Egypt."

On Jeweled Stand is Eye of Horus.

You can also see an Ornate Door and a Large Black Jackal here.

>take eye
The Eye glows in your hands as you feel power surge through your body. Taking command of it you banish the sandstorm outside the howl of the sandstorm that has filled your ears for so long finally vanish. 

"Well done," the Jackal comments, "Your task is done and the storm has vanished. You may finally leave this place." he nods at you before he walks into the shadows. "Farewell, and may we meet again." In a flash of light you find yourself out of the tomb and back in the desert. You flinch at the bright sunlight and when your eyes have adjusted you find yourself on the outskirts of Cairo. Glancing back at desert you frown. You feel something heavy in your pocket. You reach down and find a hefty amount of Gold and Silver along with a note: 

 Child of Man, may your life be filled with blessings.

    *** The End ***

Would you like to RESTART, RESTORE a saved game, QUIT, or UNDO the last command?

>undo
Treasury
[Previous turn undone.]

>ask anubis about name
There is no reply.

>ask anubis about his name
The Jackal blinks in confusion. He clearly wasn't expecting you to say that. 
 "My name is Anubis, I am the guardian of this tomb." he says.

>x jackal
He is large black jackal with a golden collar around its neck. His crimson eyes stare into your soul. He's grown fond of you, strangely.

>take eye
You take hold of the Eye as you feel power rush through your body. It feels like your mind and soul are about to burst. Anubis cries out in alarm, concerned about your well-being. But the sensation fades and when you open your eyes, the Eye is gone! 
 You look around desperately before you realize something is on your wrist, A gold, silver, and sapphire bracelet with an large diamond in the center. 

"The Eye has chosen a new wielder." Anubis says with reverence, "I had suspected that there was something special about you, my lord." he bows, "My body and soul are yours to command." Vitality wells through your body like a river, and you grin. "Let's leave this place, Anubis," you say as both you and your companion vanish from the tomb and into a new world.

    *** The End ***

Would you like to RESTART, RESTORE a saved game, QUIT, or UNDO the last command?

* * *

>switch flashlight on
You turn the flashlight on, providing a small source of light for now. You better be careful, it doesn't look like you have much battery left.

Entrance
The hallway is covered in dozens of various depictions of Ancient Egyptian art depicing the life of the Pharoah and his Queen. It is slightly stuffy here, no doubt due the amount of time that this tomb has been sealed away.

You can see a Torch here.

>x torch
A torch that smells like oil.

>take torch
Taken.

>light torch with matches
You manage to light the torches with the match. It burns brightly in your grip, illuminating everything around you.
That's already lit.

>north
Main hall
The main hall is a wonderous location, the walls rich with dozens of hieroglyphs as well as various pictures of the King and Queen as they adorn the walls. It shows their triumphs as they ruled their kingdom with a strange artifact in hand. It is a large jewel with gold decorations. It looks very important.

You can see a Queen's Door and a King's Door here.

Your flashlight sputters and dies. You shake it before you realize that it is really dead before throwing it away in disgust. Thankfully you lit the torch before you came in so you have some lighting.

>x walls
On the mural on the left is the Pharoah of Egypt, the crown of kingdom rests upon his head. He holds a flail and a crook in hand, symbols of his authority as the ruler of the kingdom. On the right wall is the Pharoah's bride, the Queen.

>x queen
You can't see any such thing.

>x queen's door
You touch the beautiful pictures that adorn the door before you hear a voice. 

 "You are not welcome here. Leave this place now!" 

You are startled by the sudden noise as you look around for where the voice came from. When you turn back to the door, you realize that there is something inside.

* * *

>west
(first opening the King's Door)
It seems to be locked.

>east
(first opening the Queen's Door)

Hall of the moon
The Hall is filled with adornments, praising the Queen entombed here. There is a ornate door to the north and the Main hall is to the west.
 "I warned you to leave." the voice growls again. It is then that you realize that the voice is coming from the Jackal! 
 "Why are you still here?" he asks menacingly, slowly getting closer to you. Maybe you should try talk to him…‮桔牥⁥獩愠漠湲瑡⁥潤牯琠⁯桴⁥潮瑲⁨湡⁤桴⁥慍湩栠

You can see a Silver Door, a Queen's Door, and a Large Black Jackal here.

>talk to jackal
You explain to the jackal why you're here, that you're stuck here because of a sandstorm and you can't get out. The jackal narrows his eyes and tilts his head. 

"It seems you aren't lying." he says. "This tomb is protected by that sandstorm, if you want to leave you will need to open the Treasury and claim the Eye of Horus. I will be watching you…" 

The jackal turns and leaves the room and goes into the main hall.

>undo
Hall of the moon
[Previous turn undone.]

>l
Hall of the moon
The Hall is filled with adornments, praising the Queen entombed here. There is a ornate door to the north and the Main hall is to the west.

You can see a Silver Door, a Queen's Door, and a Large Black Jackal here.

>explain to jackal
That's not a verb I recognise.

>talk to jackal
You explain to the jackal why you're here, that you're stuck here because of a sandstorm and you can't get out. The jackal narrows his eyes and tilts his head. 

"It seems you aren't lying." he says. "This tomb is protected by that sandstorm, if you want to leave you will need to open the Treasury and claim the Eye of Horus. I will be watching you…" 

The jackal turns and leaves the room and goes into the main hall.

>west
Main hall
The main hall is a wonderous location, the walls rich with dozens of hieroglyphs as well as various pictures of the King and Queen as they adorn the walls. It shows their triumphs as they ruled their kingdom with a strange artifact in hand. It is a large jewel with gold decorations. It looks very important.

You can see a Queen's Door, a King's Door, and a Large Black Jackal here.

>talk to jackal
Try asking about something instead.

>ask about tomb
You can't see any such thing.

>ask jackal about tomb
"This is the tomb of the greatest of the Kings and Queens of Egypt. This is also the resting place to the Eye of Horus, a powerful artifact." 
 He glares at you. "I do NOT take well to theives here."

>ask jackal about the tomb
There is no reply.

>west
(first opening the King's Door)
It seems to be locked.

>east
Hall of the moon
The Hall is filled with adornments, praising the Queen entombed here. There is a ornate door to the north and the Main hall is to the west.

You can see a Queen's Door and a Silver Door here.

>door
That's not a verb I recognise.

>open door
Which do you mean, the Queen's Door or the Silver Door?

>silver
It seems to be locked.

>x door
Which do you mean, the Queen's Door or the Silver Door?

>silver door
An ornate stone door with a mirror in the center. It looks like you could pry the mirror off if you tried to.

>take mirror
The mirror pops off of the door easily, as if it was meant to come off. You hear the sound of stones grinding as the door to the Queen's chamber slowly opens.

* * *

>take amulet
"It seems you were trustworthy after all." the jackal states as he walks into the chamber. "If you weren't the amulet would have burned you to ash. But you still are alive and well. You will need to claim the Pharoah's crown to open the Treasury." The Jackal moves back out the door where he came in

>south
Hall of the moon
The Hall is filled with adornments, praising the Queen entombed here. There is a ornate door to the north and the Main hall is to the west.

You can see a Silver Door and a Queen's Door here.

>west
Main hall
The main hall is a wonderous location, the walls rich with dozens of hieroglyphs as well as various pictures of the King and Queen as they adorn the walls. It shows their triumphs as they ruled their kingdom with a strange artifact in hand. It is a large jewel with gold decorations. It looks very important.

You can see a Queen's Door, a King's Door, and a Large Black Jackal here.

>light lanterns with matches
You light the lanterns with your matches. The moment the second one is lit, the door clicks audiably.

>light lanterns with torch
You light the lanterns with your torch. The moment the second one is lit, the door slowly creaks open.

>west
(first opening the King's Door)

Hall of the Sun
This chamber is dedicated to the triumphs that the Pharoah went through in life. Sunlight shines from a opening in the ceiling onto a pedestal in the center of the room.

You can see a Golden Door, a King's Door, and Pedestal (empty) here.

* * *

>x pedestal
A large pedestal with a circular frame. It looks like the mirror could fit here…

>north
(first opening the Golden Door)

King's chamber
The King's chamber displays his grandeur and wealth, as well as his glory as the ruler of Egypt. The crown rests on a pedestal before you, shining like a glowing star.

You can see a Golden Door and King's Crown here.

>take crown
You take the crown from the pedestal and you feel its weight in your hands. It feels strange to hold such a precious treasure. But it looks like you have all the things you need to open the treasury.

But the quickly jackal rushes into the room, "There are intruders in the tomb! Seal the King's chamber or else they will defile it!" he shouts, he's clearly panicked. He tosses you a golden key. 

 "I have already locked the Queen's chamber. Hurry!"

>lock door
What do you want to lock the Golden Door with?

>crown
That doesn't seem to fit the lock.

>close the golden door
That's already closed.

>lock the door
What do you want to lock the Golden Door with?

>crown
That doesn't seem to fit the lock.

>l
King's chamber
The King's chamber displays his grandeur and wealth, as well as his glory as the ruler of Egypt. The crown rests on a pedestal before you, shining like a glowing star.

You can see a Golden Key, a Large Black Jackal, and a Golden Door here.

>take key
Taken.

>lock door
What do you want to lock the Golden Door with?

>key
You quickly lock the door with the key that was given to you. The jackal quickly nods, moving off to the side of the room. 

 "Pull this," he says as he indicates to hidden protrusion on the wall. It looks like an ancient lever. "It will take you back to the Main Hall. Then we can deal with the intruders permanently."

>undo
King's chamber
[Previous turn undone.]

>open door
You shake your head. There's no way you're going to win a fight against multiple people. You better stay out of it…

>south
(first opening the Golden Door)
You shake your head. There's no way you're going to win a fight against multiple people. You better stay out of it…

>unso
That's not a verb I recognise.

>undo
King's chamber
[Previous turn undone.]

>undo
King's chamber
[Previous turn undone.]

>south
(first opening the Golden Door)
You shake your head. There's no way you're going to win a fight against multiple people. You better stay out of it…

>enter hall of teh sun
You can't see any such thing.

>north
You can't go that way.

>south
(first opening the Golden Door)
You shake your head. There's no way you're going to win a fight against multiple people. You better stay out of it…

>north
You can't go that way.

>talk to jackal
Try asking about something instead.

I beg your pardon?

>talk jackal
I didn't understand that sentence.

>ask jackal about name
There is no reply.

>ask jackal about his name
The Jackal blinks in confusion. He clearly wasn't expecting you to say that. 
 "My name is Anubis, I am the guardian of this tomb." he says.

>give jackal food
(first taking Dry Survival Food)
The jackal looks at you. "I live off of the energies of the temple. I don't need to eat anything." But something tells you that he appreciated the offer.

>x Anubis
He is large black jackal with a golden collar around its neck. His crimson eyes stare into your soul. He's grown fond of you, strangely.

>lock door with key
You quickly lock the door with the key that was given to you. The jackal quickly nods, moving off to the side of the room. 

 "Pull this," he says as he indicates to hidden protrusion on the wall. It looks like an ancient lever. "It will take you back to the Main Hall. Then we can deal with the intruders permanently."

>x rune
You can't see any such thing.

>press rune
You can't see any such thing.

>x rune
You can't see any such thing.

>l
King's chamber
The King's chamber displays his grandeur and wealth, as well as his glory as the ruler of Egypt. The crown rests on a pedestal before you, shining like a glowing star.

You can see a Large Black Jackal and a Golden Door here.

>switch rune on
You can't see any such thing.

>pull lever
The wall slides open, revealing a hidden passageway. The Jackal quickly descends into the dark tunnel as you follow after him. When you finally reach the end, you find yourself back into the Main Hall as the passageway closes behind you. 

 The Jackal nods towards the entrance to the King's door. "All that is left is to lock them in the room. There is not that many things of value in there, thankfully. I managed to take the mirror with me before I left."

Main hall
The main hall is a wonderous location, the walls rich with dozens of hieroglyphs as well as various pictures of the King and Queen as they adorn the walls. It shows their triumphs as they ruled their kingdom with a strange artifact in hand. It is a large jewel with gold decorations. It looks very important.

You can see a Queen's Door and a King's Door here.

* * *

>switch flashlight on
You turn the flashlight on, providing a small source of light for now. You better be careful, it doesn't look like you have much battery left.

Entrance
The hallway is covered in dozens of various depictions of Ancient Egyptian art depicing the life of the Pharoah and his Queen. It is slightly stuffy here, no doubt due the amount of time that this tomb has been sealed away.

You can see a Torch here.

>take torcj
You can't see any such thing.

>take torch
Taken.

>north
Main hall
The main hall is a wonderous location, the walls rich with dozens of hieroglyphs as well as various pictures of the King and Queen as they adorn the walls. It shows their triumphs as they ruled their kingdom with a strange artifact in hand. It is a large jewel with gold decorations. It looks very important. A foutain of glittering water lies in the center of the room.

You can see a Queen's Door and a King's Door here.

Your flashlight sputters and dies. You shake it before you realize that it is really dead before throwing it away in disgust.  
It is now pitch dark in here!

>light torch with matches
You manage to light the torches with the match. It burns brightly in your grip, illuminating everything around you.
That's already lit.

Main hall
The main hall is a wonderous location, the walls rich with dozens of hieroglyphs as well as various pictures of the King and Queen as they adorn the walls. It shows their triumphs as they ruled their kingdom with a strange artifact in hand. It is a large jewel with gold decorations. It looks very important. A foutain of glittering water lies in the center of the room.

You can see a Queen's Door and a King's Door here.

>east
(first opening the Queen's Door)
You touch the beautiful pictures that adorn the door before you hear a voice. 

 "You are not welcome here. Leave this place now!" 

You are startled by the sudden noise as you look around for where the voice came from. When you turn back to the door, you realize that there is something inside.

>east
(first opening the Queen's Door)

Hall of the moon
The Hall is filled with adornments, praising the Queen entombed here. There is a ornate door to the north and the Main hall is to the west.
 "I warned you to leave." the voice growls again. It is then that you realize that the voice is coming from the Jackal! 
 "Why are you still here?" he asks menacingly, slowly getting closer to you. Maybe you should try talk to him…‮桔牥⁥獩愠漠湲瑡⁥潤牯琠⁯桴⁥潮瑲⁨湡⁤桴⁥慍湩栠

You can see a Silver Door, a Queen's Door, and a Large Black Jackal here.

* * *

>talk to jackal
You explain to the jackal why you're here, that you're stuck here because of a sandstorm and you can't get out. The jackal narrows his eyes and tilts his head. 

"It seems you aren't lying." he says. "This tomb is protected by that sandstorm, if you want to leave you will need to open the Treasury and claim the Eye of Horus. I will be watching you…" 

The jackal turns and leaves the room and goes into the main hall.

>west
Main hall
The main hall is a wonderous location, the walls rich with dozens of hieroglyphs as well as various pictures of the King and Queen as they adorn the walls. It shows their triumphs as they ruled their kingdom with a strange artifact in hand. It is a large jewel with gold decorations. It looks very important. A foutain of glittering water lies in the center of the room.

You can see a Queen's Door, a King's Door, and a Large Black Jackal here.

>ask jackal about name
There is no reply.

* * *

>ask jackal about his name
The Jackal blinks in confusion. He clearly wasn't expecting you to say that. 
 "My name is Anubis, I am the guardian of this tomb." he says.

>ask jackal about tomb
"This is the tomb of the greatest of the Kings and Queens of Egypt. This is also the resting place to the Eye of Horus, a powerful artifact." 
 He glares at you. "I do NOT take well to theives here."

>ask jackal about thieves
"Unfortunately there have been many people attempting to make their way in. Most of the time the magic of the tomb keeps them out. But it let you in." he replies. "I still don't trust you though."

>give jackal food
(first taking Dry Survival Food)
The jackal looks at you. "I live off of the energies of the temple. I don't need to eat anything." But something tells you that he appreciated the offer.

>east
Hall of the moon
The Hall is filled with adornments, praising the Queen entombed here. There is a ornate door to the north and the Main hall is to the west.

You can see a Queen's Door and a Silver Door here.

>take mirror
The mirror pops off of the door easily, as if it was meant to come off. You hear the sound of stones grinding as the door to the Queen's chamber slowly opens.

* * *

>take amulet
"It seems you were trustworthy after all." the jackal states as he walks into the chamber. 

"If you weren't the amulet would have burned you to ash. But you still are alive and well. You will need to claim the Pharoah's crown to open the Treasury." The Jackal moves back out the door where he came in

>west
You can't go that way.

>east
You can't go that way.

>south
Hall of the moon
The Hall is filled with adornments, praising the Queen entombed here. There is a ornate door to the north and the Main hall is to the west.

You can see a Silver Door and a Queen's Door here.

* * *

>west
Main hall
The main hall is a wonderous location, the walls rich with dozens of hieroglyphs as well as various pictures of the King and Queen as they adorn the walls. It shows their triumphs as they ruled their kingdom with a strange artifact in hand. It is a large jewel with gold decorations. It looks very important.

You can see a Queen's Door, a King's Door, and a Large Black Jackal here.

>x kings door
You can't see any such thing.

>x king's door
A large stone door with two oil lanterns.

>x lanterns
A pair of unlit lanterns.

>light lanterns with matches
You light the lanterns with your matches. The moment the second one is lit, the door clicks audiably.
It's already unlocked.

>west
(first opening the King's Door)

Hall of the Sun
This chamber is dedicated to the triumphs that the Pharoah went through in life. Sunlight shines from a opening in the ceiling onto a pedestal in the center of the room.

You can see a Golden Door and a King's Door here.

>x pedestal
A large pedestal with a circular frame. It looks like the mirror could fit here…냰ƶ

>put mirror in pedestal
You put the mirror into the pedestal and you are nearly blinded as the shining mirror redirects the sunlight into you eyes. The moment you move out of the way, the beam of sunlight shines upon the jewel in the door's center. It shines red as the door slowly rumbles open.

>rotate pedestal
It is fixed in place.

>rotate pedestal
It is fixed in place.

>adjust pedestal
I didn't understand that sentence.

>adjust the pedestal
I didn't understand that sentence.

>adjust pedestal
I didn't understand that sentence.

>adjust mirror
I didn't understand that sentence.

>north
King's chamber
The King's chamber displays his grandeur and wealth, as well as his glory as the ruler of Egypt. The King's sarcophagus lies in the enter of the room, glittering in the light. The crown rests on a pedestal before you, shining like a glowing star.

You can see a Golden Door and King's Crown here.

>x coffin
The King's gold and silver sarcophagus. It is much more elaborate than the Queen's. It must be worth a fortune!

>take crown
You take the crown from the pedestal and you feel its weight in your hands. It feels strange to hold such a precious treasure. But it looks like you have all the things you need to open the treasury.

But the quickly jackal rushes into the room as it slams shute behind him, "There are intruders in the tomb! Seal the King's chamber or else they will defile it!" he shouts, he's clearly panicked. He tosses you a golden key. 

 "I have already locked the Queen's chamber. Hurry!"

* * *

>lock door with key
You quickly lock the door with the key that was given to you. The jackal quickly nods and takes the key back from you, moving off to the side of the room. 

 "Pull this," he says as he indicates to hidden protrusion on the wall. It looks like an ancient lever. "It will take you back to the Main Hall. Then we can deal with the intruders permanently."

>pull lever
The wall slides open, revealing a hidden passageway. The Jackal quickly descends into the dark tunnel as you follow after him. When you finally reach the end, you find yourself back into the Main Hall as the passageway closes behind you. 

 The Jackal nods towards the entrance to the King's door. "All that is left is to lock them in the room. There is not that many things of value in there, thankfully. I managed to take the mirror with me before I left."

Main hall
The main hall is a wonderous location, the walls rich with dozens of hieroglyphs as well as various pictures of the King and Queen as they adorn the walls. It shows their triumphs as they ruled their kingdom with a strange artifact in hand. It is a large jewel with gold decorations. It looks very important.

You can see a Queen's Door and a King's Door here.

>extinguish lanterns
You blow out both lanterns quickly. The moment the second one goes out the door slams shut.
 You hear a cry of alarm as the thievs realize that they're trapped in the room!

I beg your pardon?

>undo
Main hall
[Previous turn undone.]

>undo
King's chamber
[Previous turn undone.]

>open door
You shake your head. There's no way you're going to win a fight against multiple people. You better stay out of it…汰⹥

>unlock door
What do you want to unlock the Golden Door with?

>key
That's unlocked at the moment.

>lock door with key
You quickly lock the door with the key that was given to you. The jackal quickly nods and takes the key back from you, moving off to the side of the room. 

 "Pull this," he says as he indicates to hidden protrusion on the wall. It looks like an ancient lever. "It will take you back to the Main Hall. Then we can deal with the intruders permanently."

>unlock door wiht key
I didn't understand that sentence.

>unlock door with key
You can't see any such thing.

>lock door with key
You can't see any such thing.

>pull lever
The wall slides open, revealing a hidden passageway. The Jackal quickly descends into the dark tunnel as you follow after him. When you finally reach the end, you find yourself back into the Main Hall as the passageway closes behind you. 

 The Jackal nods towards the entrance to the King's door. "All that is left is to lock them in the room. There is not that many things of value in there, thankfully. I managed to take the mirror with me before I left."

Main hall
The main hall is a wonderous location, the walls rich with dozens of hieroglyphs as well as various pictures of the King and Queen as they adorn the walls. It shows their triumphs as they ruled their kingdom with a strange artifact in hand. It is a large jewel with gold decorations. It looks very important.

You can see a Queen's Door and a King's Door here.

* * *

After hours of wandering through the desert, you find shelter from a sandstorm in a mysterious building. You have no idea where you are, but you are about to find out…

Desert Treasure
An Interactive Fiction by Austin Ishii
Release 1 / Serial number 131017 / Inform 7 build 6G60 (I6/v6.32 lib 6/12N) SD

Darkness
It is pitch dark, and you can't see a thing.

>north
(first opening the Stone Door)
You try to open the door but it's locked. Now that you think about it, don't you have a flashlight with you?

>x door
You can't see any such thing.

>i
You are carrying:
  Survival Kit
    Flashlight
    Matches
    Dry Survival Food

>feel around
You can't see any such thing.

>south
Desert
You wince as you open the doors outside. The sandstorm that forced you to come make it impossible leave the tomb. Looks like you're stuck here until the storm subsides.

>x desert
All you can see is a blinding sandstrom that rages before you.

>north
Darkness
It is pitch dark, and you can't see a thing.

>north
(first opening the Stone Door)
It seems to be locked.

>i
You are carrying:
  Survival Kit
    Flashlight
    Matches
    Dry Survival Food

>take all
You just can't seem to be able to do that.

>take flashlight
Taken.

>take matches
Taken.

>take survival food
Taken.

* * *

After hours of wandering through the desert, you find shelter from a sandstorm in a mysterious building. You have no idea where you are, but you are about to find out…

Desert Treasure
An Interactive Fiction by Austin Ishii
Release 1 / Serial number 131017 / Inform 7 build 6G60 (I6/v6.32 lib 6/12N) SD

Darkness
It is pitch dark, and you can't see a thing.

>i
You are carrying:
  Survival Kit
    Flashlight
    Matches
    Dry Survival Food

>x kit
It is pitch dark, and you can't see a thing.

>switch on flashlight
You turn the flashlight on, providing a small source of light for now. You better be careful, it doesn't look like you have much battery left.

Entrance
The hallway is covered in dozens of various depictions of Ancient Egyptian art depicing the life of the Pharoah and his Queen. It is slightly stuffy here, no doubt due the amount of time that this tomb has been sealed away.

You can see Torch here.

>take torch
Taken.

>north
Main hall
The main hall is a wonderous location, the walls rich with dozens of hieroglyphs as well as various pictures of the King and Queen as they adorn the walls. It shows their triumphs as they ruled their kingdom with a strange artifact in hand. It is a large jewel with gold decorations. It looks very important.

Your flashlight sputters and dies. You shake it before you realize that it is really dead before throwing it away in disgust.  
It is now pitch dark in here!

>light torch with matches
You manage to light the torches with the match. It burns brightly in your grip, illuminating everything around you.

Main hall
The main hall is a wonderous location, the walls rich with dozens of hieroglyphs as well as various pictures of the King and Queen as they adorn the walls. It shows their triumphs as they ruled their kingdom with a strange artifact in hand. It is a large jewel with gold decorations. It looks very important.

>i
You are carrying:
  Torch (providing light)
  Survival Kit
    Matches
    Survival Food

>undo
Main hall
[Previous turn undone.]

>undo
Darkness
[Previous turn undone.]

>undo
Entrance
[Previous turn undone.]

>x walls
You can't see any such thing.

>nort
That's not a verb I recognise.

>north
Main hall
The main hall is a wonderous location, the walls rich with dozens of hieroglyphs as well as various pictures of the King and Queen as they adorn the walls. It shows their triumphs as they ruled their kingdom with a strange artifact in hand. It is a large jewel with gold decorations. It looks very important.

Your flashlight sputters and dies. You shake it before you realize that it is really dead before throwing it away in disgust.  
It is now pitch dark in here!

>light torch
This dangerous act would achieve little.

>light torch with matches
You manage to light the torches with the match. It burns brightly in your grip, illuminating everything around you.

Main hall
The main hall is a wonderous location, the walls rich with dozens of hieroglyphs as well as various pictures of the King and Queen as they adorn the walls. It shows their triumphs as they ruled their kingdom with a strange artifact in hand. It is a large jewel with gold decorations. It looks very important.

>x walls
Your fingers touch the painted walls of the crypt when you suddenly hear a mysterious voice. 
"You are not welcome here. Leave this place now!" 
You are startled by the sudden noise as you look around for where the voice came from. You manage to see a shadowy figure enter the door on the east.

>east
Hall of the Moon
You can see Large Black Jackal here.

>x jackal
He is large black jackal with a golden collar around its neck. His crimson eyes stare into your soul.

>talk to jackal
You explain to the jackal why you're here. You're stuck here because of a sandstorm and you can't get out. The jackal narrows his eyes and tilts his head. 
 "It seems you aren't lying." he says. You may stay here for now, but do not take anything. The jackal turns and leaves the room and goes into the main hall.

>talk to jackal about name
You can't see any such thing.

>talk to jackal about his name
You can't see any such thing.

>ask jackal about his name
You can't see any such thing.

>talk to jackal
You can't see any such thing.

>east
You can't go that way.

>west
Main hall
The main hall is a wonderous location, the walls rich with dozens of hieroglyphs as well as various pictures of the King and Queen as they adorn the walls. It shows their triumphs as they ruled their kingdom with a strange artifact in hand. It is a large jewel with gold decorations. It looks very important.

You can see Large Black Jackal here.

* * *

>ask jackal about his name
The Jackal blinks in confusion. He clearly wasn't expecting you to say that. 
 "My name is Anubis, I am the guardian of this tomb." he says.

* * *

>talk to anubis about his name
I only understood you as far as wanting to talk to Large Black Jackal.

>ask anubis about his name
The Jackal blinks in confusion. He clearly wasn't expecting you to say that. 
 "My name is Anubis, I am the guardian of this tomb." he says.

* * *

>i
You are carrying:
  Survival Kit
    Flashlight
    Matches
    Dry Survival Food

>take flashlight
Taken.

* * *

>take matches
Taken.

>take dry food
Taken.

>switch on flashlight
You turn the flashlight on, providing a small source of light for now. You better be careful, it doesn't look like you have much battery left.

Entrance
The hallway is covered in dozens of various depictions of Ancient Egyptian art depicing the life of the Pharoah and his Queen. It is slightly stuffy here, no doubt due the amount of time that this tomb has been sealed away.

You can see a Torch here.

>take torch
Taken.

* * *

>light torch with matches
You manage to light the torches with the match. It burns brightly in your grip, illuminating everything around you.

Main hall
The main hall is a wonderous location, the walls rich with dozens of hieroglyphs as well as various pictures of the King and Queen as they adorn the walls. It shows their triumphs as they ruled their kingdom with a strange artifact in hand. It is a large jewel with gold decorations. It looks very important.

>x jewel
Your fingers touch the painted walls of the crypt when you suddenly hear a mysterious voice. 
"You are not welcome here. Leave this place now!" 
You are startled by the sudden noise as you look around for where the voice came from. You manage to see a shadowy figure enter the door on the east.

>x fountain
A gold and silver fountain filled with sparkling water.

In Fountain is Water.

>take water
You empty out your survival kit and fill it with the water.

>i
You are carrying:
  Matches
  Dry Survival Food
  a Torch (providing light)
  Survival Kit
    Water

>west
Hall of the Sun
This chamber is dedicated to the triumphs that the Pharoah went through in life. He ruled the people kindly but he kept them in line with his laws, as a king should.

>east
Main hall
The main hall is a wonderous location, the walls rich with dozens of hieroglyphs as well as various pictures of the King and Queen as they adorn the walls. It shows their triumphs as they ruled their kingdom with a strange artifact in hand. It is a large jewel with gold decorations. It looks very important.

>east
Hall of the Moon
The Hall is filled with adornments, praising the Queen entombed here. There is a ornate stone door to the north and the Main hall is to the west. 
 "I warned you to leave." the voice growls again. It is then that you realize that the voice is coming from the Jackal! 
 "Why are you still here?" he asks menacingly, slowly getting closer to you. Maybe you should try talk to him…h慷湲摥礠畯琠⁯敬癡⹥"or to the north and t"or to the north and t"or to the north and t"or to the north

You can see a Silver Door, a Large Black Jackal, and a Silver Mirror here.

>talk to jackal
You explain to the jackal why you're here. You're stuck here because of a sandstorm and you can't get out. The jackal narrows his eyes and tilts his head. 
 "It seems you aren't lying." he says. "You may stay here…for now.敹⁳湡⁤楴瑬⁳楨慪正污眠票礠畯爧⁥敨敲‮潙❵敲猠畴正" The jackal turns and leaves the room and goes into the main hall.

>x door
An ornate stone door with a mirror in the center. It looks like you could pry the mirror off if you tried...

>take mirror
The mirror pops off of the door easily, as if it was meant to come off. You hear the sound of stones grinding as the door to the Queen's chamber slowly opens.

* * *

>north
(first opening the Silver Door)

Queen's Chamber
The Queen's resting place is covered in hundreds of various pictures, depicting the Queen in all of her splendor. Her sarcophagus lies in the center of the tomb, undisturbed. However, there is a shining amulet on the wall in the back.

You can see a Silver Door and Queen's Amulet here.

>take amulet
Taken.

>x coffin
You can't see any such thing.

>open sarcophagus
You shake your head. The dead deserve more respect than this. Besides, you're not nearly strong enough to open it anyway.

* * *

>i
You are carrying:
  Survival Kit
    Flashlight
    Matches
    Dry Survival Food

>switch on flashlight
You turn the flashlight on, providing a small source of light for now. You better be careful, it doesn't look like you have much battery left.

Entrance
The hallway is covered in dozens of various depictions of Ancient Egyptian art depicing the life of the Pharoah and his Queen. It is slightly stuffy here, no doubt due the amount of time that this tomb has been sealed away.

You can see Torch here.

>x entrance
You can't see any such thing.

>l
Entrance
The hallway is covered in dozens of various depictions of Ancient Egyptian art depicing the life of the Pharoah and his Queen. It is slightly stuffy here, no doubt due the amount of time that this tomb has been sealed away.

You can see Torch here.

>take torch
Taken.

* * *

>light torch with matches
You manage to light the torches with the match. It burns brightly in your grip, illuminating everything around you.

>switch flashlight off
You switch the flashlight off.

>l
Entrance
The hallway is covered in dozens of various depictions of Ancient Egyptian art depicing the life of the Pharoah and his Queen. It is slightly stuffy here, no doubt due the amount of time that this tomb has been sealed away.

>switch flashlight on
You turn the flashlight on, providing a small source of light for now. You better be careful, it doesn't look like you have much battery left.

>north
Main hall
The main hall is a wonderous location, the walls rich with dozens of hieroglyphs as well as various pictures of the King and Queen as they adorn the walls. It shows their triumphs as they ruled their kingdom with a strange artifact in hand. It is a large jewel with gold decorations. It looks very important.

You marvel at the scenery that is displayed before you. You somehow managed to find an Ancient Egyptian Tomb in the middle of nowhere! Since you cannot leave, you might as well explore the area. Those walls look interesting. 

That is before your flashlight sputters and dies. You shake it before you realize that it is really dead before throwing it away in disgust. Thankfully you lit the torch before you came in so you have some lighting.

>x flashlight
You can't see any such thing.

>x walls
Your fingers touch the painted walls of the crypt when you suddenly hear a mysterious voice. 
"You are not welcome here. Leave this place now!" 
You are startled by the sudden noise as you look around for where the voice came from. You manage to see a shadowy figure enter the door on the east.

You marvel at the scenery that is displayed before you. You somehow managed to find an Ancient Egyptian Tomb in the middle of nowhere! Since you cannot leave, you might as well explore the area. Those walls look interesting. 

That is before your flashlight sputters and dies. You shake it before you realize that it is really dead before throwing it away in disgust. Thankfully you lit the torch before you came in so you have some lighting.

>east
Hall of the Queen

* * *

>i
You are carrying:
  Survival Kit
    Flashlight
    Matches
    Dry Survival Food

>take all
There are none at all available!

>switch on flashlight
You turn the flashlight on, providing a small source of light for now. You better be careful, it doesn't look like you have much battery left.

Entrance
The hallway is covered in dozens of various depictions of Ancient Egyptian art depicing the life of the Pharoah and his Queen. It is slightly stuffy here, no doubt due the amount of time that this tomb has been sealed away.

You can see a Torch here.

* * *

>take torch
Taken.

>north
Main hall
The main hall is a wonderous location, the walls rich with dozens of hieroglyphs as well as various pictures of the King and Queen as they adorn the walls. It shows their triumphs as they ruled their kingdom with a strange artifact in hand. It is a large jewel with gold decorations. It looks very important.

You can see a Stone Door here.

Your flashlight sputters and dies. You shake it before you realize that it is really dead before throwing it away in disgust.  
It is now pitch dark in here!

>light torches with match
You can't see any such thing.

>light torch with match
You manage to light the torches with the match. It burns brightly in your grip, illuminating everything around you.

Main hall
The main hall is a wonderous location, the walls rich with dozens of hieroglyphs as well as various pictures of the King and Queen as they adorn the walls. It shows their triumphs as they ruled their kingdom with a strange artifact in hand. It is a large jewel with gold decorations. It looks very important.

You can see a Stone Door here.

>light torch with matches
You manage to light the torches with the match. It burns brightly in your grip, illuminating everything around you.

>x wall
You can't see any such thing.

>x door
A large stone door with two oil lanterns.

>light lanterns with ltorch
You can't see any such thing.

>x walls
Your fingers touch the painted walls of the crypt when you suddenly hear a mysterious voice. 
"You are not welcome here. Leave this place now!" 
You are startled by the sudden noise as you look around for where the voice came from. You manage to see a shadowy figure enter the door on the east.

>east
Hall of the Moon
The Hall is filled with adornments, praising the Queen entombed here. There is a ornate stone door to the north and the Main hall is to the west. 
 "I warned you to leave." the voice growls again. It is then that you realize that the voice is coming from the Jackal! 
 "Why are you still here?" he asks menacingly, slowly getting closer to you. Maybe you should try talk to him…⁉慷湲摥礠畯琠⁯敬癡⹥"or to the north and the"or to the north and the"or to the north and the"or to the nort

You can see a Silver Door and a Large Black Jackal here.

>talk to jackal
You explain to the jackal why you're here. You're stuck here because of a sandstorm and you can't get out. The jackal narrows his eyes and tilts his head. 
 "It seems you aren't lying." he says. "This tomb is protected by that sandstorm, if you want to leave you will need to open the Treasury and claim the Eye of Horus. I will be watching you…" The jackal turns and leaves the room and goes into the main hall.

>x mirror
A large silver mirror that shines in the light of your torch.

>x door
An ornate stone door with a mirror in the center. It looks like you could pry the mirror off if you tried to.

>take mirror
The mirror pops off of the door easily, as if it was meant to come off. You hear the sound of stones grinding as the door to the Queen's chamber slowly opens.

>x mirror
A large silver mirror that shines in the light of your torch.

>nortgh
That's not a verb I recognise.

>north
(first opening the Silver Door)

Queen's Chamber
The Queen's resting place is covered in hundreds of various pictures, depicting the Queen in all of her splendor. Her sarcophagus lies in the center of the tomb, undisturbed. However, there is a shining amulet on the wall in the back.

You can see a Silver Door and Queen's Amulet here.

* * *

>take amulet
"It seems you were trustworthy after all." the jackal states as he walks into the chamber. "If you weren't the amulet would have burned you to ash. But you still are alive and well. You will need to claim the Pharoah's crown to open the Treasury." The Jackal moves back out the door where he came in

>south
Hall of the Moon
The Hall is filled with adornments, praising the Queen entombed here. There is a ornate stone door to the north and the Main hall is to the west. 

You can see a Silver Door here.

>west
Main hall
The main hall is a wonderous location, the walls rich with dozens of hieroglyphs as well as various pictures of the King and Queen as they adorn the walls. It shows their triumphs as they ruled their kingdom with a strange artifact in hand. It is a large jewel with gold decorations. It looks very important.

You can see a Stone Door and a Large Black Jackal here.

>x door
A large stone door with two oil lanterns.

>light lanterns with torch
You light the lanterns with your torch. The moment the second one is lit, the door slowly creaks open.

>west
(first opening the Stone Door)

Hall of the Sun
This chamber is dedicated to the triumphs that the Pharoah went through in life. He ruled the people kindly but he kept them in line with his laws, as a king should.

You can see a Stone Door here.

>extinguish lanterns
You can't see any such thing.

>x door
A large stone door with two  two lit lanterns that are burning brightly.

>undo
Hall of the Sun
[Previous turn undone.]

>l
Hall of the Sun
This chamber is dedicated to the triumphs that the Pharoah went through in life. He ruled the people kindly but he kept them in line with his laws, as a king should.

You can see a Stone Door here.

>unlock door
What do you want to unlock the Stone Door with?

>x lanterns
You can't see any such thing.

>west
You can't go that way.

>light lanterns with torch
You can't see any such thing.

>l
Hall of the Sun
This chamber is dedicated to the triumphs that the Pharoah went through in life. He ruled the people kindly but he kept them in line with his laws, as a king should.

You can see a Stone Door here.

>west
You can't go that way.

>east
Main hall
The main hall is a wonderous location, the walls rich with dozens of hieroglyphs as well as various pictures of the King and Queen as they adorn the walls. It shows their triumphs as they ruled their kingdom with a strange artifact in hand. It is a large jewel with gold decorations. It looks very important.

You can see a Stone Door and a Large Black Jackal here.

>extinguish lanterns
You blow out both lanterns quickly. The moment the second one goes out the door slams shut.
The lanterns are already unlit.

>west
Hall of the Sun
This chamber is dedicated to the triumphs that the Pharoah went through in life. He ruled the people kindly but he kept them in line with his laws, as a king should.

You can see a Stone Door here.

>east
Main hall
The main hall is a wonderous location, the walls rich with dozens of hieroglyphs as well as various pictures of the King and Queen as they adorn the walls. It shows their triumphs as they ruled their kingdom with a strange artifact in hand. It is a large jewel with gold decorations. It looks very important.

You can see a Stone Door and a Large Black Jackal here.

>x door
A large stone door with two oil lanterns.

>extinguish lanterns
The lanterns are already unlit.

>west
Hall of the Sun
This chamber is dedicated to the triumphs that the Pharoah went through in life. He ruled the people kindly but he kept them in line with his laws, as a king should.

You can see a Stone Door here.

>undo
Main hall
[Previous turn undone.]

* * *

After hours of wandering through the desert, you find shelter from a sandstorm in a mysterious building. You have no idea where you are, but you are about to find out…

Desert Treasure
An Interactive Fiction by Austin Ishii
Release 1 / Serial number 131017 / Inform 7 build 6G60 (I6/v6.32 lib 6/12N) SD

Darkness
It is pitch dark, and you can't see a thing.

>x room
You can't see any such thing.

>i
You are carrying:
  Survival Kit
    Flashlight
    Matches
    Dry Survival Food

* * *

>take all
There are none at all available!

>take flashlight
Taken.

* * *

>take matches
Taken.

>take food
Taken.

>x flashlight
It is pitch dark, and you can't see a thing.

>switch on flashlight
You turn the flashlight on, providing a small source of light for now. You better be careful, it doesn't look like you have much battery left.

Entrance
The hallway is covered in dozens of various depictions of Ancient Egyptian art depicing the life of the Pharoah and his Queen. It is slightly stuffy here, no doubt due the amount of time that this tomb has been sealed away.

You can see a Torch here.

* * *

>light torch with matches
You manage to light the torches with the match. It burns brightly in your grip, illuminating everything around you.

>light torch
This dangerous act would achieve little.

>x torch
A lit torch that burns brightly .

>l
Entrance
The hallway is covered in dozens of various depictions of Ancient Egyptian art depicing the life of the Pharoah and his Queen. It is slightly stuffy here, no doubt due the amount of time that this tomb has been sealed away.

>x walls
You can't see any such thing.

>north
Main hall
The main hall is a wonderous location, the walls rich with dozens of hieroglyphs as well as various pictures of the King and Queen as they adorn the walls. It shows their triumphs as they ruled their kingdom with a strange artifact in hand. It is a large jewel with gold decorations. It looks very important.

Your flashlight sputters and dies. You shake it before you realize that it is really dead before throwing it away in disgust. Thankfully you lit the torch before you came in so you have some lighting.

>l
Main hall
The main hall is a wonderous location, the walls rich with dozens of hieroglyphs as well as various pictures of the King and Queen as they adorn the walls. It shows their triumphs as they ruled their kingdom with a strange artifact in hand. It is a large jewel with gold decorations. It looks very important.

>x walls
You marvel at the ancient crypt when you suddenly hear a mysterious voice. 
"You are not welcome here. Leave this place now!" 
You are startled by the sudden noise as you look around for where the voice came from. You manage to see a shadowy figure enter the door on the east.

>east
Hall of the Moon
The Hall is filled with adornments, praising the Queen entombed here. There is a ornate stone door to the north and the Main hall is to the west.

You can see a Silver Door, a Large Black Jackal, and Mirror here.

>take mirror
The mirror pops off of the door easily, as if it was meant to come off. You hear the sound of stones grinding as the door to the Queen's chamber slowly opens.

>talk to jackal
You explain to the jackal why you're here. You're stuck here because of a sandstorm and you can't get out. The jackal narrows his eyes and tilts his head. 
 "It seems you aren't lying." he says. "You may stay here…for now.攠灸湡⁤楴瑬⁳楨⁳敨摡‮ 礠畯爧⁥敨敲‮潙❵敲猠畴正栠牥⁥敢慣獵⁥景愠猠湡獤潴浲愠"" The jackal turns and leaves the room and goes into the main hall.

>north
(first opening the Silver Door)

Queen's Chamber
The Queen's resting place is covered in hundreds of various pictures, depciting the Queen in all of her splendor.

You can see a Silver Door here.

* * *

After hours of wandering through the desert, you find shelter from a sandstorm in a mysterious building. You have no idea where you are, but you are about to find out…

Desert Treasure
An Interactive Fiction by Austin Ishii
Release 1 / Serial number 131017 / Inform 7 build 6G60 (I6/v6.32 lib 6/12N) SD

Darkness
It is pitch dark, and you can't see a thing.

>n
(first opening the Stone Door)
You try to open the door but it's locked. Now that you think about it, don't you have a flashlight with you?

>i
You are carrying:
  Survival Kit
    Flashlight
    Matches
    Dry Survival Food

>x flashlight
It is pitch dark, and you can't see a thing.

>use flashlight
That's not a verb I recognise.

>turn on flashlight
You turn the flashlight on, providing a small source of light for now. You better be careful, it doesn't look like you have much battery left.

Entrance
The hallway is covered in dozens of various depictions of Ancient Egyptian art depicing the life of the Pharoah and his Queen. It is slightly stuffy here, no doubt due the amount of time that this tomb has been sealed away.

You can see a Stone Door, Brass Key, and a Torch here.

>take torch
Taken.

>take all
You just can't seem to be able to do that.

>take key
Taken.

>turn off flashlight
You switch the flashlight off.

It is now pitch dark in here!

>light match
This dangerous act would achieve little.

>i
You are carrying:
  Brass Key
  a Torch
  Survival Kit
    Flashlight
    Matches
    Dry Survival Food

>light torch with matches
You manage to light the torches with the match. It burns brightly in your grip, illuminating everything around you.

Entrance
The hallway is covered in dozens of various depictions of Ancient Egyptian art depicing the life of the Pharoah and his Queen. It is slightly stuffy here, no doubt due the amount of time that this tomb has been sealed away.

You can see a Stone Door here.

>unlock door with key
You unlock the Stone Door.

>w
You can't go that way.

>s
Desert
You wince as you open the doors outside. The sandstorm that forced you to come make it impossible leave the tomb. Looks like you're stuck here until the storm subsides.

>n
Entrance
The hallway is covered in dozens of various depictions of Ancient Egyptian art depicing the life of the Pharoah and his Queen. It is slightly stuffy here, no doubt due the amount of time that this tomb has been sealed away.

You can see a Stone Door here.

>e
You can't go that way.

>n
(first opening the Stone Door)

Main hall
The main hall is a wonderous location, the walls rich with dozens of hieroglyphs as well as various pictures of the King and Queen as they adorn the walls. It shows their triumphs as they ruled their kingdom with a strange artifact in hand. It is a large jewel with gold decorations. It looks very important. A foutain of glittering water lies in the center of the room.

You can see a Queen's Door, a King's Door, an Ornate Door, and a Stone Door here.

>x walls
On the mural on the left is the Pharoah of Egypt, the crown of kingdom rests upon his head. He holds a flail and a crook in hand, symbols of his authority as the ruler of the kingdom. On the right wall is the Pharoah's bride, the Queen.

>x jewel
On the mural on the left is the Pharoah of Egypt, the crown of kingdom rests upon his head. He holds a flail and a crook in hand, symbols of his authority as the ruler of the kingdom. On the right wall is the Pharoah's bride, the Queen.

I beg your pardon?

>x water
Sparkling clean water. You're surprised that it looks so fresh.

>drink water
You are sorely tempted to but it's probably several hundred years old. It's not sanitary at all.

>open queen's door
You touch the beautiful pictures that adorn the door before you hear a voice. 

 "You are not welcome here. Leave this place now!" 

You are startled by the sudden noise as you look around for where the voice came from. When you turn back to the door, you realize that there is something inside.

>open door
Which do you mean, the Queen's Door, the King's Door, the Ornate Door, or the Stone Door?

>x queen's door
A door with a picture of the Queen that is covered in Hieroglyphics.

>open queen's door
You open the Queen's Door.

>w
(first opening the King's Door)
It seems to be locked.

>f
That's not a verb I recognise.

>e
Hall of the moon
The Hall is filled with adornments, praising the Queen entombed here. There is a ornate door to the north and the Main hall is to the west.
 "I warned you to leave." the voice growls again. It is then that you realize that the voice is coming from the Jackal! 
 "Why are you still here?" he asks menacingly, slowly getting closer to you. Maybe you should try talk to him…⁤潹

You can see a Silver Door, a Queen's Door, and a Large Black Jackal here.

>x jackal
He is large black jackal with a golden collar around its neck. His crimson eyes stare into your soul.

>take jackal
I don't suppose the Large Black Jackal would care for that.

>talk to jackal
You explain to the jackal why you're here, that you're stuck here because of a sandstorm and you can't get out. The jackal narrows his eyes and tilts his head. 

"It seems you aren't lying." he says. "This tomb is protected by that sandstorm, if you want to leave you will need to open the Treasury and claim the Eye of Horus. I will be watching you…" 

The jackal turns and leaves the room and goes into the main hall.

>n
(first opening the Silver Door)
It seems to be locked.

>open silver door
It seems to be locked.

>i
You are carrying:
  Brass Key
  a Torch (providing light)
  Survival Kit
    Flashlight
    Matches
    Dry Survival Food

>eat food
(first taking Dry Survival Food)
That's plainly inedible.

>unlock silver door
What do you want to unlock the Silver Door with?

>brass key
That doesn't seem to fit the lock.

>w
Main hall
The main hall is a wonderous location, the walls rich with dozens of hieroglyphs as well as various pictures of the King and Queen as they adorn the walls. It shows their triumphs as they ruled their kingdom with a strange artifact in hand. It is a large jewel with gold decorations. It looks very important. A foutain of glittering water lies in the center of the room.

You can see a Queen's Door, a King's Door, an Ornate Door, a Stone Door, and a Large Black Jackal here.

>open king's door
It seems to be locked.

>unlock king's door with brass key
That doesn't seem to fit the lock.

>x king's door
A large stone door with two oil lanterns.

>take lanterns
That's hardly portable.

>x lanterns
A pair of unlit lanterns.

>light lanterns
This dangerous act would achieve little.

>light lanterns with matches
You light the lanterns with your matches. The moment the second one is lit, the door clicks audiably.
It's already unlocked.

>n
(first opening the Ornate Door)
It's locked.
You slowly open the door with apprehension on your face.

Treasury
A room filled with various treasures. All of Egypt's wealth is here. In the center of the room is a bejeweled pedestal with a diamond set in gold, silver, and lapis-lazuli. It glows with a mysterious power.

 "Behold." the Jackal states, "The Eye of Horus, the greatest treasure in all of Egypt."

On Jeweled Stand is Eye of Horus.

You can also see an Ornate Door and a Large Black Jackal here.

>s
Main hall
The main hall is a wonderous location, the walls rich with dozens of hieroglyphs as well as various pictures of the King and Queen as they adorn the walls. It shows their triumphs as they ruled their kingdom with a strange artifact in hand. It is a large jewel with gold decorations. It looks very important. A foutain of glittering water lies in the center of the room.

You can see an Ornate Door, a Stone Door, a Queen's Door, and a King's Door here.

>e
Hall of the moon
The Hall is filled with adornments, praising the Queen entombed here. There is a ornate door to the north and the Main hall is to the west.

You can see a Queen's Door and a Silver Door here.

>x silver door
An ornate stone door with a mirror in the center. It looks like you could pry the mirror off if you tried to.

>pry mirror off
That's not a verb I recognise.

>take mirror
The mirror pops off of the door easily, as if it was meant to come off. You hear the sound of stones grinding as the door to the Queen's chamber slowly opens.

>n
(first opening the Silver Door)

Queen's Chamber
The Queen's resting place is covered in hundreds of various pictures, depicting the Queen in all of her splendor. Her sarcophagus lies in the center of the tomb, undisturbed. However, there is a shining amulet on the wall in the back.

You can see a Silver Door and Queen's Amulet here.

>take amulet
"It seems you were trustworthy after all." the jackal states as he walks into the chamber. 

"If you weren't the amulet would have burned you to ash. But you still are alive and well. You will need to claim the Pharoah's crown to open the Treasury." The Jackal moves back out the door where he came in

>x sarcophagus
The Queen's gold and silver sarcophagus. Strange considering that usually the Queen never has one. The Pharoah must have gotten it for her.

>take sarcophagus
That's hardly portable.

>jump
You jump on the spot, fruitlessly.

>x pictures
You can't see any such thing.

>l
Queen's Chamber
The Queen's resting place is covered in hundreds of various pictures, depicting the Queen in all of her splendor. Her sarcophagus lies in the center of the tomb, undisturbed. However, there is a shining amulet on the wall in the back.

You can see a Silver Door here.

>i
You are carrying:
  Queen's Amulet
  a Silver Mirror
  Dry Survival Food
  Brass Key
  a Torch (providing light)
  Survival Kit
    Flashlight
    Matches

>s
Hall of the moon
The Hall is filled with adornments, praising the Queen entombed here. There is a ornate door to the north and the Main hall is to the west.

You can see a Silver Door and a Queen's Door here.

>w
Main hall
The main hall is a wonderous location, the walls rich with dozens of hieroglyphs as well as various pictures of the King and Queen as they adorn the walls. It shows their triumphs as they ruled their kingdom with a strange artifact in hand. It is a large jewel with gold decorations. It looks very important. A foutain of glittering water lies in the center of the room.

You can see a Queen's Door, a King's Door, an Ornate Door, and a Stone Door here.

>n
Treasury
A room filled with various treasures. All of Egypt's wealth is here. In the center of the room is a bejeweled pedestal with a diamond set in gold, silver, and lapis-lazuli. It glows with a mysterious power.

On Jeweled Stand is Eye of Horus.

You can also see an Ornate Door and a Large Black Jackal here.

>s
Main hall
The main hall is a wonderous location, the walls rich with dozens of hieroglyphs as well as various pictures of the King and Queen as they adorn the walls. It shows their triumphs as they ruled their kingdom with a strange artifact in hand. It is a large jewel with gold decorations. It looks very important. A foutain of glittering water lies in the center of the room.

You can see an Ornate Door, a Stone Door, a Queen's Door, and a King's Door here.

>w
(first opening the King's Door)

Hall of the Sun
This chamber is dedicated to the triumphs that the Pharoah went through in life. Sunlight shines from a opening in the ceiling onto a pedestal in the center of the room.

You can see a Golden Door and a King's Door here.

>x sunlight
You can't see any such thing.

>x opening
You can't see any such thing.

>x ceiling
You can't see any such thing.

>x pedestal
A large pedestal with a circular frame. It looks like the mirror could fit here…

>put mirror on pedestal
Putting things on Pedestal would achieve nothing.

>fit mirror in pedestal
That's not a verb I recognise.

>x mirror
A large silver mirror that shines in the light of your torch.

>combine mirror and pedestal
That's not a verb I recognise.

>w
You can't go that way.

>e
Main hall
The main hall is a wonderous location, the walls rich with dozens of hieroglyphs as well as various pictures of the King and Queen as they adorn the walls. It shows their triumphs as they ruled their kingdom with a strange artifact in hand. It is a large jewel with gold decorations. It looks very important. A foutain of glittering water lies in the center of the room.

You can see a King's Door, an Ornate Door, a Stone Door, and a Queen's Door here.

>n
Treasury
A room filled with various treasures. All of Egypt's wealth is here. In the center of the room is a bejeweled pedestal with a diamond set in gold, silver, and lapis-lazuli. It glows with a mysterious power.

On Jeweled Stand is Eye of Horus.

You can also see an Ornate Door and a Large Black Jackal here.

* * *

>n
(first opening the Stone Door)
You try to open the door but it's locked. Now that you think about it, don't you have a flashlight with you?

>x symbols
You can't see any such thing.

>open the door
You can't see any such thing.

>open stone door
You can't see any such thing.

>n
(first opening the Stone Door)
It seems to be locked.

>n
(first opening the Stone Door)
It seems to be locked.

>s
Desert
You wince as you open the doors outside. The sandstorm that forced you to come make it impossible leave the tomb. Looks like you're stuck here until the storm subsides.

>s
You can't go that way.

>s
You can't go that way.

>n
Darkness
It is pitch dark, and you can't see a thing.

>n
(first opening the Stone Door)
It seems to be locked.

>e
You can't go that way.

>x door
You can't see any such thing.

>w
You can't go that way.

>e
You can't go that way.

>talk to jackal
You can't see any such thing.

>n
(first opening the Stone Door)
It seems to be locked.

>w
Darkness
It is pitch dark, and you can't see a thing.

* * *

After hours of wandering through the desert, you find shelter from a sandstorm in a mysterious building. You have no idea where you are, but you are about to find out…

Desert Treasure
An Interactive Fiction by Austin Ishii
Release 1 / Serial number 131017 / Inform 7 build 6G60 (I6/v6.32 lib 6/12N) SD

Darkness
It is pitch dark, and you can't see a thing.

>switch on flashlight
You turn the flashlight on, providing a small source of light for now. You better be careful, it doesn't look like you have much battery left.

Entrance
The hallway is bare of deecorations. It is slightly stuffy here, no doubt due the amount of time that this place has been sealed away.

You can see a Stone Door, Brass Key, and a Torch here.

>take ke
You can't see any such thing.

>take kye
You can't see any such thing.

>take key
Taken.

>take torch
Taken.

>north
(first opening the Stone Door)
You try to open the door but it's locked.

>unlock door
What do you want to unlock the Stone Door with?

>key
You unlock the Stone Door.

>north
(first opening the Stone Door)

Main hall
The main hall is a wonderous location, the walls rich with dozens of hieroglyphs as well as various pictures of the King and Queen as they adorn the walls. It shows their triumphs as they ruled their kingdom with a strange artifact in hand. A large diamond set in a frame of gold and sapphire. A fountain of glittering water lies in the center of the room.

You can see a Queen's Door, a King's Door, an Ornate Door, and a Stone Door here.

Your flashlight sputters and dies. You shake it before you realize that it is really dead before throwing it away in disgust.  
It is now pitch dark in here!

>i
You are carrying:
  a Torch
  Brass Key
  Survival Kit
    Matches
    Dry Survival Food

>light torch with matches
You manage to light the torches with the match. It burns brightly in your grip, illuminating everything around you.

Main hall
The main hall is a wonderous location, the walls rich with dozens of hieroglyphs as well as various pictures of the King and Queen as they adorn the walls. It shows their triumphs as they ruled their kingdom with a strange artifact in hand. A large diamond set in a frame of gold and sapphire. A fountain of glittering water lies in the center of the room.

You can see a Queen's Door, a King's Door, an Ornate Door, and a Stone Door here.

>north
(first opening the Ornate Door)
It's locked.

>x ornate door
A very ornate door decorated with gold and silver hieroglyphs. The Queen and the King are on opposite sides of the door. There's a feather-shaped slot and a crown shaped slot in the center of the door.

>west
The door is locked.

>east
(first opening the Queen's Door)
You touch the beautiful pictures that adorn the door before you hear a voice. 

 "You are not welcome here. Leave this place now!" 

You are startled by the sudden noise as you look around for where the voice came from. When you turn back to the door, you realize that there is something inside.

>light lanterns with matches
You light the lanterns with your matches. The moment the second one is lit, the door slowly opens.

>light lanterns with matches
It's already unlocked.

>light lanterns with torch
The door is already unlocked.

>east
(first opening the Queen's Door)

Hall of the moon
The Hall dedicated to the Queen as well, depicting her in her splendor. There is a Ornate door to the north and the Main hall is to the west.

 "I warned you to leave." the voice growls again. It is then that you realize that the voice is coming from the Jackal! 

 "Why are you still here?" he asks menacingly, slowly getting closer to you. Maybe you should try talk to him…

You can see a Silver Door, a Queen's Door, and a Large Black Jackal here.

>talk to jackal
You explain to the jackal why you're here, that you're stuck here because of a sandstorm and you can't get out. The jackal narrows his eyes and tilts his head. 

"It seems you aren't lying." he says. "This tomb is protected by that sandstorm, if you want to leave you will need to open the Treasury and claim the Eye of Horus. I will be watching you…" 

The jackal turns and leaves the room and goes into the main hall. You still have some questions though!

>x door
Which do you mean, the Silver Door or the Queen's Door?

>silver door
An silver door with a mirror in the center. It looks like you could take the mirror off if you tried to.

>pry mirror off
I didn't understand that sentence.

>pry mirror off door
The mirror pops off of the door easily, as if it was meant to come off. You hear the sound of stones grinding as the door to the Queen's chamber slowly opens.

>pry mirror off
I didn't understand that sentence.

>pry mirror off door
You already have that.

>x pictures
They're beautiful but you have more important things to think about.

>north
(first opening the Silver Door)

Queen's Chamber
The Queen's resting place is covered in hundreds of various pictures, depicting the Queen in all of her splendor. Her sarcophagus lies in the center of the tomb, undisturbed. 

You can see a Silver Door and Queen's Amulet here.

>take amulet
"It seems you were trustworthy after all." the jackal states as he walks into the chamber. 

"If you weren't the amulet would have burned you to ash. But you still are alive and well. You will need to claim the Pharoah's crown to open the Treasury." The Jackal moves back out the door where he came in

>l
Queen's Chamber
The Queen's resting place is covered in hundreds of various pictures, depicting the Queen in all of her splendor. Her sarcophagus lies in the center of the tomb, undisturbed. However, there is a shining amulet on the wall in the back.

You can see a Silver Door here.

>south
Hall of the moon
The Hall dedicated to the Queen as well, depicting her in her splendor. There is a Ornate door to the north and the Main hall is to the west.

You can see a Silver Door and a Queen's Door here.

>west
Main hall
The main hall is a wonderous location, the walls rich with dozens of hieroglyphs as well as various pictures of the King and Queen as they adorn the walls. It shows their triumphs as they ruled their kingdom with a strange artifact in hand. A large diamond set in a frame of gold and sapphire. A fountain of glittering water lies in the center of the room.

You can see a Queen's Door, a King's Door, an Ornate Door, a Stone Door, and a Large Black Jackal here.

>wets
That's not a verb I recognise.

>west
Hall of the Sun
This chamber is dedicated to the triumphs that the Pharoah went through in life. Sunlight shines from a opening in the ceiling onto a pedestal in the center of the room.

You can see a Golden Door and a King's Door here.

>fit mirror in pedestal
That's not a verb I recognise.

>insert mirror into pedestal
You put the mirror into the pedestal and you are nearly blinded as the shining mirror redirects the sunlight into you eyes. The moment you move out of the way, the beam of sunlight shines upon the jewel in the door's center. It shines red as the door slowly rumbles open.

>undo
Hall of the Sun
[Previous turn undone.]

>x pedestal
A large pedestal with a circular frame. It looks like the mirror could be inserted into there…

>insert mirror
I didn't understand that sentence.

>x door
Which do you mean, the Golden Door or the King's Door?

>golden door
A Golden door with a large picture of an eye in the center. There's a large glass jewel there where the iris would be, but it looks like you can't take it off.

>undo
Hall of the Sun
[Previous turn undone.]

>undo
Hall of the Sun
[Previous turn undone.]

>x door
Which do you mean, the Golden Door or the King's Door?

* * *

>golden door
A Golden door with a large picture of an eye in the center. There's a large glass jewel there where the iris would be, but it looks like you can't take it off.

>x golden door
A Golden door with a large picture of an eye in the center. There's a large glass jewel there where the iris would be, but it looks like you can't take it off.

>x king's door
A heavy door with two lit lanterns that are burning brightly on the sides.

>close golden door
That's already closed.

>x golden door
A Golden door with a large picture of an eye in the center. There's a large glass jewel there where the iris would be, but it looks like you can't take it off.

>insert mirror into pedestal
You put the mirror into the pedestal and you are nearly blinded as the shining mirror redirects the sunlight into you eyes. The moment you move out of the way, the beam of sunlight shines upon the jewel in the door's center. It shines red as the door slowly rumbles open.

>x door
Which do you mean, the Golden Door or the King's Door?

* * *

>golden door
A Golden door with a large picture of an eye in the center. There's a large glass jewel there where the iris would be, but it looks like you can't take it off.

>north
King's chamber
The King's chamber displays his grandeur and wealth, as well as his glory as the ruler of Egypt. The King's sarcophagus lies in the enter of the room, glittering in the light. The crown rests on a pedestal before you, shining like a glowing star.

You can see a Golden Door and King's Crown here.

* * *

>take crown
You take the crown from the pedestal and you feel its weight in your hands. It feels strange to hold such a precious treasure. But it looks like you have all the things you need to open the treasury.

But the quickly jackal rushes into the room as it slams shute behind him, "There are intruders in the tomb! Seal the King's chamber or else they will defile it!" he shouts, he's clearly panicked. He tosses you a golden key. 

 "I have already locked the Queen's chamber. Hurry!"

>wear crown
You try to but it's just too big.

>lock golden door
What do you want to lock the Golden Door with?

>key
Which do you mean, the Golden Key or Brass Key?

>lock golden door with gold key
You can't see any such thing.

>take key
Which do you mean, the Golden Key or Brass Key?

>lock golden door with golden key
You quickly lock the door with the key that was given to you. The jackal quickly nods and takes the key back from you, moving off to the side of the room. 

 "Pull this," he says as he indicates to hidden protrusion on the wall. It looks like an ancient lever. "It will take you back to the Main Hall. Then we can deal with the intruders permanently."

>pull lever
The wall slides open, revealing a hidden passageway. The Jackal quickly descends into the dark tunnel as you follow after him. When you finally reach the end, you find yourself back into the Main Hall as the passageway closes behind you. 

 The Jackal nods towards the entrance to the King's door. "All that is left is to lock them in the room. There is not that many things of value in there, thankfully. I managed to take the mirror with me before I left. Lock the door so I can get rid of the intruders. 
Main hall
The main hall is a wonderous location, the walls rich with dozens of hieroglyphs as well as various pictures of the King and Queen as they adorn the walls. It shows their triumphs as they ruled their kingdom with a strange artifact in hand. A large diamond set in a frame of gold and sapphire. A fountain of glittering water lies in the center of the room.

You can see a Queen's Door, a King's Door, an Ornate Door, and a Stone Door here.

>north
(first opening the Ornate Door)
It's locked.
The Jackal shakes his head, "You should probably get rid of the intruders first."

>west
There's no way you're going in there while there's intruders still there! It's suicidal!

>east
Hall of the moon
The Hall dedicated to the Queen as well, depicting her in her splendor. There is a Ornate door to the north and the Main hall is to the west.

You can see a Silver Door and a Queen's Door here.

>west
Main hall
The main hall is a wonderous location, the walls rich with dozens of hieroglyphs as well as various pictures of the King and Queen as they adorn the walls. It shows their triumphs as they ruled their kingdom with a strange artifact in hand. A large diamond set in a frame of gold and sapphire. A fountain of glittering water lies in the center of the room.

You can see a Queen's Door, a King's Door, an Ornate Door, a Stone Door, and a Large Black Jackal here.

>east
Hall of the moon
The Hall dedicated to the Queen as well, depicting her in her splendor. There is a Ornate door to the north and the Main hall is to the west.

You can see a Queen's Door and a Silver Door here.

>east
You can't go that way.

>l
Hall of the moon
The Hall dedicated to the Queen as well, depicting her in her splendor. There is a Ornate door to the north and the Main hall is to the west.

You can see a Queen's Door and a Silver Door here.

>undo
Hall of the moon
[Previous turn undone.]

>undo
Hall of the moon
[Previous turn undone.]

>undo
Main hall
[Previous turn undone.]

>undo
Hall of the moon
[Previous turn undone.]

* * *

>undo
Main hall
[Previous turn undone.]

>undo
"Undo" failed.  [Not all interpreters provide it.]

>west
There's no way you're going in there while there's intruders still there! It's suicidal!

* * *

>west
Main hall
The main hall is a wonderous location, the walls rich with dozens of hieroglyphs as well as various pictures of the King and Queen as they adorn the walls. It shows their triumphs as they ruled their kingdom with a strange artifact in hand. A large diamond set in a frame of gold and sapphire. A fountain of glittering water lies in the center of the room.

You can see a Queen's Door, a King's Door, an Ornate Door, a Stone Door, and a Large Black Jackal here.

>extiguish lanterns
That's not a verb I recognise.

>x door
Which do you mean, the Queen's Door, the King's Door, the Ornate Door, or the Stone Door?

>king's door
A heavy door with two lit lanterns that are burning brightly on the sides.

>extinguish lanterns
You blow out both lanterns quickly. The moment the second one goes out the door slams shut.
 You hear a cry of alarm as the thieves realize that they're trapped in the room!

The Jackal nods, "Good." he says "Stand back from the door," he instructs. 

After you do so, his eyes glows red. There's a bright flash of light that forces you to close your eyes. You hear the screams of the thieves before the voices are cut off. When you open your eyes nothing seems to have been changed. 

 "The thives are gone now." the Jackal smirked, "Thank you for your assistance." he says, smiling.

>north
(first opening the Ornate Door)
It's locked.

>insert crown into door
Which do you mean, the Queen's Door, the King's Door, the Ornate Door, or the Stone Door?

>ornate door
The Crown slides in with a gentle click as it glows.

>x door
Which do you mean, the Queen's Door, the King's Door, the Ornate Door, or the Stone Door?

>ornate door
A very ornate door decorated with gold and silver hieroglyphs. The Queen and the King are on opposite sides of the door. There's a feather-shaped slot and a crown shaped slot in the center of the door.

>insert crown into slot
The Crown slides in with a gentle click as it glows with power.

>insert amulet in slot
The Amulet slides in with a gentle click as it glows.

The ornate door clicks as it glows with power before the locks fall away. 

"Good" the Jackal says he he takes both artifacts. "Now the treasury is open."

>north
(first opening the Ornate Door)
You slowly open the door with apprehension on your face.

Treasury
A room filled with various treasures. All of Egypt's wealth is here. In the center of the room is a bejeweled pedestal with a diamond set in gold, silver, and lapis-lazuli. It glows with a mysterious power.

 "Behold." the Jackal states, "The Eye of Horus, the greatest treasure in all of Egypt."

On Jeweled Stand is Eye of Horus.

You can also see an Ornate Door and a Large Black Jackal here.

* * *

>undo
Treasury
[Previous turn undone.]

>undo
Main hall
[Previous turn undone.]

>undo
Main hall
[Previous turn undone.]

>unlock door with crown
Which do you mean, the Queen's Door, the King's Door, the Ornate Door, or the Stone Door?

>ornate door
(first taking King's Crown)
You should probably insert them into the slots.

>insert crown into ornate door
The Crown slides in with a gentle click as it glows.

* * *

After hours of wandering through the desert, you find shelter from a sandstorm in a mysterious building. You have no idea where you are, but you are about to find out…

Desert Treasure
An Interactive Fiction by Austin Ishii
Release 1 / Serial number 131017 / Inform 7 build 6G60 (I6/v6.32 lib 6/12N) SD

Darkness
It is pitch dark, and you can't see a thing.

>feel around
You can't see any such thing.

>north
(first opening the Stone Door)
You try to open the door but it's locked. Now that you think about it, don't you have a flashlight with you?

>south
Desert
You wince as you open the doors outside. The sandstorm that forced you to come make it impossible leave the tomb. Looks like you're stuck here until the storm subsides.

>north
Darkness
It is pitch dark, and you can't see a thing.

>i
You are carrying:
  Survival Kit
    Flashlight
    Matches
    Dry Survival Food

>switch flashlight on
You turn the flashlight on, providing a small source of light for now. You better be careful, it doesn't look like you have much battery left.

Entrance
The hallway is bare of deecorations. It is slightly stuffy here, no doubt due the amount of time that this place has been sealed away.

You can see a Stone Door, Brass Key, and a Torch here.

>take key
Taken.

>take door
That's fixed in place.

>take torch
Taken.

>unlock door with key
You unlock the Stone Door.

>north
(first opening the Stone Door)

Main hall
The main hall is a wonderous location, the walls rich with dozens of hieroglyphs as well as various pictures of the King and Queen as they adorn the walls. It shows their triumphs as they ruled their kingdom with a strange artifact in hand. A large diamond set in a frame of gold and sapphire. A fountain of glittering water lies in the center of the room. The treasury is to the North, the Queen's door is to the East, the Stone door is to the south, and the King's door is to the West.

You can see a Queen's Door, a King's Door, an Ornate Door, and a Stone Door here.

Your flashlight sputters and dies. You shake it before you realize that it is really dead before throwing it away in disgust.  
It is now pitch dark in here!

>i
You are carrying:
  a Torch
  Brass Key
  Survival Kit
    Matches
    Dry Survival Food

>l
Darkness
It is pitch dark, and you can't see a thing.

>i
You are carrying:
  a Torch
  Brass Key
  Survival Kit
    Matches
    Dry Survival Food

>light matches
This dangerous act would achieve little.

>strike matches
The match gives you a few seconds of light but it flickers and fades. You should probably light something with them.

>heel
That's not a verb I recognise.

>strike match
The match gives you a few seconds of light but it flickers and fades. You should probably light something with them.

>nothing
That's not a verb I recognise.

>light torch with matches
You manage to light the torches with the match. It burns brightly in your grip, illuminating everything around you.

Main hall
The main hall is a wonderous location, the walls rich with dozens of hieroglyphs as well as various pictures of the King and Queen as they adorn the walls. It shows their triumphs as they ruled their kingdom with a strange artifact in hand. A large diamond set in a frame of gold and sapphire. A fountain of glittering water lies in the center of the room. The treasury is to the North, the Queen's door is to the East, the Stone door is to the south, and the King's door is to the West.

You can see a Queen's Door, a King's Door, an Ornate Door, and a Stone Door here.

>south
Entrance
The hallway is bare of deecorations. It is slightly stuffy here, no doubt due the amount of time that this place has been sealed away.

You can see a Stone Door here.

>north
Main hall
The main hall is a wonderous location, the walls rich with dozens of hieroglyphs as well as various pictures of the King and Queen as they adorn the walls. It shows their triumphs as they ruled their kingdom with a strange artifact in hand. A large diamond set in a frame of gold and sapphire. A fountain of glittering water lies in the center of the room. The treasury is to the North, the Queen's door is to the East, the Stone door is to the south, and the King's door is to the West.

You can see a Stone Door, a Queen's Door, a King's Door, and an Ornate Door here.

>west
The King's door is locked.

>x door
Which do you mean, the Stone Door, the Queen's Door, the King's Door, or the Ornate Door?

>king's door
A heavy door with two oil lanterns on the sides.

>east
(first opening the Queen's Door)
You touch the beautiful pictures that adorn the door before you hear a voice. 

 "You are not welcome here. Leave this place now!" 

You are startled by the sudden noise as you look around for where the voice came from. When you turn back to the door, you realize that there is something inside.

>north
(first opening the Ornate Door)
It's locked.

>east
(first opening the Queen's Door)

Hall of the moon
The Hall dedicated to the Queen as well, depicting her in her splendor. There is a Ornate door to the north and the Main hall is to the west.

 "I warned you to leave." the voice growls again. It is then that you realize that the voice is coming from the Jackal! 

 "Why are you still here?" he asks menacingly, slowly getting closer to you. Maybe you should try talk to him…

You can see a Silver Door, a Queen's Door, and a Large Black Jackal here.

* * *

>talk to jackal
You explain to the jackal why you're here, that you're stuck here because of a sandstorm and you can't get out. The jackal narrows his eyes and tilts his head. 

"It seems you aren't lying." he says. "This tomb is protected by that sandstorm, if you want to leave you will need to open the Treasury and claim the Eye of Horus. I will be watching you…" 

The jackal turns and leaves the room and goes into the main hall. You still have some questions though!

>west
Main hall
The main hall is a wonderous location, the walls rich with dozens of hieroglyphs as well as various pictures of the King and Queen as they adorn the walls. It shows their triumphs as they ruled their kingdom with a strange artifact in hand. A large diamond set in a frame of gold and sapphire. A fountain of glittering water lies in the center of the room. The treasury is to the North, the Queen's door is to the East, the Stone door is to the south, and the King's door is to the West.

You can see a Queen's Door, a King's Door, an Ornate Door, a Stone Door, and a Large Black Jackal here.

>talk to jackal
Try asking about something instead.

* * *

>ask about tomb
You can't see any such thing.

>ask jackal about tomb
"This is the tomb of the greatest of the Kings and Queens of Egypt. This is also the resting place to the Eye of Horus, a powerful artifact," the Jackal says.

He glares at you. "I do NOT take well to thieves here."

>ask Jackal about name
There is no reply.

>ask jackal about his name
The Jackal blinks in confusion. He clearly wasn't expecting you to say that. 

"My name is Anubis, I am the guardian of this tomb. It is a pleasure to meet you." he says.

>west
The King's door is locked.

>east
Hall of the moon
The Hall dedicated to the Queen as well, depicting her in her splendor. There is a Ornate door to the north and the Main hall is to the west.

You can see a Queen's Door and a Silver Door here.

>north
(first opening the Silver Door)
It seems to be locked.

>x silver door
An silver door with a mirror in the center. It looks like you could take the mirror off if you tried to.

>take mirror
The mirror pops off of the door easily, as if it was meant to come off. You hear the sound of stones grinding as the door to the Queen's chamber slowly opens.

>north
(first opening the Silver Door)

Queen's Chamber
The Queen's resting place is covered in hundreds of various pictures, depicting the Queen in all of her splendor. Her sarcophagus lies in the center of the tomb, undisturbed. There is a shining amulet on the wall in the back.

You can see a Silver Door and Queen's Amulet here.

>take amulet
"It seems you were trustworthy after all." the jackal states as he walks into the chamber. 

"If you weren't the amulet would have burned you to ash. But you still are alive and well. You will need to claim the Pharoah's crown to open the Treasury." The Jackal moves back out the door where he came in

>x pictures
They're beautiful but you have more important things to think about.

>south
Hall of the moon
The Hall dedicated to the Queen as well, depicting her in her splendor. There is a Ornate door to the north and the Main hall is to the west.

You can see a Silver Door and a Queen's Door here.

>south
You can't go that way.

>west
Main hall
The main hall is a wonderous location, the walls rich with dozens of hieroglyphs as well as various pictures of the King and Queen as they adorn the walls. It shows their triumphs as they ruled their kingdom with a strange artifact in hand. A large diamond set in a frame of gold and sapphire. A fountain of glittering water lies in the center of the room. The treasury is to the North, the Queen's door is to the East, the Stone door is to the south, and the King's door is to the West.

You can see a Queen's Door, a King's Door, an Ornate Door, a Stone Door, and a Large Black Jackal here.

>west
The King's door is locked.

>x door
Which do you mean, the Queen's Door, the King's Door, the Ornate Door, or the Stone Door?

>king's door
A heavy door with two oil lanterns on the sides.

>light lanterns
This dangerous act would achieve little.

>light lanterns with torch
You light the lanterns with your torch. The moment the second one is lit, the door clicks audiably as it slowly opens.

>west
Hall of the Sun
This chamber is dedicated to the triumphs that the Pharoah went through in life. Sunlight shines from a opening in the ceiling onto a pedestal in the center of the room. There is a golden door to the north. 

You can see a Golden Door and a King's Door here.

>x sun
There's a hole in the ceiling that letting sunlight stream down.

>x sunlight
There's a hole in the ceiling that letting sunlight stream down.

>north
(first opening the Golden Door)
It seems to be locked.

>x pedestal
A large pedestal with a circular frame. It looks like the mirror could be inserted into there…

* * *

>insert mirror
I didn't understand that sentence.

>insert mirror into pedestal
You put the mirror into the pedestal and you are nearly blinded as the shining mirror redirects the sunlight into you eyes. The moment you move out of the way, the beam of sunlight shines upon the jewel in the door's center. It shines red as the door slowly rumbles open.

>north
King's chamber
The King's chamber displays his grandeur and wealth, as well as his glory as the ruler of Egypt. The King's sarcophagus lies in the enter of the room, glittering in the light. The crown rests on a pedestal before you, shining like a glowing star.

You can see a Golden Door and King's Crown here.

* * *

>take crown
You take the crown from the pedestal and you feel its weight in your hands. It feels strange to hold such a precious treasure. But it looks like you have all the things you need to open the treasury.

But the quickly jackal rushes into the room as it slams shute behind him, "There are intruders in the tomb! Seal the King's chamber or else they will defile it!" he shouts, he's clearly panicked. He tosses you a golden key. 

 "I have already locked the Queen's chamber. Hurry!"

>l
King's chamber
The King's chamber displays his grandeur and wealth, as well as his glory as the ruler of Egypt. The King's sarcophagus lies in the enter of the room, glittering in the light. 

You can see a Large Black Jackal and a Golden Door here.

>lock golden door
What do you want to lock the Golden Door with?

* * *

>key
Which do you mean, the Golden Key or Brass Key?

>golden key
You quickly lock the door with the key that was given to you. The jackal quickly nods and takes the key back from you, moving off to the side of the room. 

 "Pull this," he says as he indicates to hidden protrusion on the wall. It looks like an ancient lever. "It will take you back to the Main Hall. Then we can deal with the intruders permanently."

>pull  lever
The wall slides open, revealing a hidden passageway. The Jackal quickly descends into the dark tunnel as you follow after him. When you finally reach the end, you find yourself back into the Main Hall as the passageway closes behind you. 

 The Jackal nods towards the entrance to the King's door. "All that is left is to lock them in the room. There is not that many things of value in there, thankfully. I managed to take the mirror with me before I left. Lock the door so I can get rid of the intruders.

Main hall
The main hall is a wonderous location, the walls rich with dozens of hieroglyphs as well as various pictures of the King and Queen as they adorn the walls. It shows their triumphs as they ruled their kingdom with a strange artifact in hand. A large diamond set in a frame of gold and sapphire. A fountain of glittering water lies in the center of the room. The treasury is to the North, the Queen's door is to the East, the Stone door is to the south, and the King's door is to the West.

You can see a Queen's Door, a King's Door, an Ornate Door, and a Stone Door here.

>west
There's no way you're going in there while there's intruders still there! It's suicidal!

>exitinguish lanterns
That's not a verb I recognise.

>extinguish lantersn
You can't see any such thing.

>extinguish lanters
You can't see any such thing.

>extinguish lanterns
You blow out both lanterns quickly. The moment the second one goes out the door slams shut.

You hear a cry of alarm as the thieves realize that they're trapped in the room!

The Jackal nods, "Good." he says "Stand back from the door," he instructs. 

After you do so, his eyes glows red. There's a bright flash of light that forces you to close your eyes. You hear the screams of the thieves before the voices are cut off. When you open your eyes nothing seems to have been changed. 

 "The thives are gone now." the Jackal smirked, "Thank you for your assistance." he says, smiling.

>west
The King's door is locked.

>light lanterns with torch
You light the lanterns with your torch. The moment the second one is lit, the door clicks audiably as it slowly opens.

* * *

>west
Hall of the Sun
This chamber is dedicated to the triumphs that the Pharoah went through in life. Sunlight shines from a opening in the ceiling onto a pedestal in the center of the room. There is a golden door to the north. 

You can see a Golden Door and a King's Door here.

>east
Main hall
The main hall is a wonderous location, the walls rich with dozens of hieroglyphs as well as various pictures of the King and Queen as they adorn the walls. It shows their triumphs as they ruled their kingdom with a strange artifact in hand. A large diamond set in a frame of gold and sapphire. A fountain of glittering water lies in the center of the room. The treasury is to the North, the Queen's door is to the East, the Stone door is to the south, and the King's door is to the West.

You can see a King's Door, an Ornate Door, a Stone Door, a Large Black Jackal, and a Queen's Door here.

>north
(first opening the Ornate Door)
It's locked.

>x door
Which do you mean, the King's Door, the Ornate Door, the Stone Door, or the Queen's Door?

>ornate door
A very ornate door decorated with gold and silver hieroglyphs. The Queen and the King are on opposite sides of the door. There's two slots in the door.

>x slots
A pair of slots in the door. You probably need to fill both of them to open the door.

>insert crown into slot
The Crown slides in with a gentle click before it glows with power.

>insert amulet into door
Which do you mean, the King's Door, the Ornate Door, the Stone Door, or the Queen's Door?

>ornate door
The Amulet slides in with a gentle click before it begins to glows.

The ornate door glows with power before the locks fall away. 

"Good" the Jackal says he he takes both artifacts. "Now the treasury is open." The Jackal moves into the Treasury.

>north
(first opening the Ornate Door)
You slowly open the door with apprehension on your face.

Treasury
The Treasury is filled with various treasures of different sizes. All of Egypt's wealth is here. In the center of the room is a bejeweled stand with a diamond set in gold, silver, and lapis-lazuli. It glows with a mysterious power.

 "Behold." the Jackal states, "The Eye of Horus, the greatest treasure in all of Egypt."

On Jeweled Stand is Eye of Horus.

You can also see an Ornate Door and a Large Black Jackal here.

>take eye
You take hold of the Eye as you feel power rush through your body. It feels like your mind and soul are about to burst. Anubis cries out in alarm, concerned about your well-being. But the sensation fades and when you open your eyes, the Eye is gone! 

You look around desperately before you realize something is on your wrist, A gold, silver, and sapphire bracelet with an large diamond in the center. 

"The Eye has chosen a new wielder." Anubis says with reverence, "I had suspected that there was something special about you, my lord." he bows, "My body and soul are yours to command." Vitality wells through your body like a river, and you grin. 

"Let's leave this place, Anubis," you say as both you and your companion vanish with but a thought with your newfound powers. A new world awaits you and your new guardian.

    *** The End ***

Would you like to RESTART, RESTORE a saved game, QUIT, or UNDO the last command?